REPEAT 3
|........####......
|......########....
|....############..
|..################
=##################
