REPEAT 1
|........................##.....
|....................##..###....
|................##..##..####...
|............##..##..##..#####..
|........##..##..##..##..######.
|....##..##..##..##..##..#######
=##..##..##..##..##..##..#######
|##..##..##..##..##..##..#######
|##..##..##..##..##..##..#######
|##..##..##..##..##..##..#######
|###############################
