REPEAT 4
|........#.
|...#....#.
|...#.##.#.
=##.#.##.#.
|##.#.##.#.
|##########
