REPEAT 4
|....#......
|...###.....
|..#####....
=###########
|###########
|###########
