REPEAT 6
|.....##...
=..##.##...
|..##.##.##
|..##.##.##
|##########
