REPEAT 1
|............#.....#..........
|............#######..........
|........#...#######...#......
|........###############......
|....#...###############...#..
=##..#######################..
|##..#######################..
|#############################
