REPEAT 4
|..........##
|........#.##
=##.#..######
|####..######
|############
