REPEAT 3
|............##.........
|..........######.......
|........##########.....
|.......############....
|.......############....
|.....################..
=....##################.
|....##################.
|#######################
