REPEAT 4
|..........#.
|....#....###
|,..###...###
=...###...###
|############
