REPEAT 4
|....##.
|...###.
|..####.
|.#####.
=#######
