REPEAT 5
|............#...#
|............#...#
|..#......#..#####
|..###..###..#####
=#################
